h - to move left
j - to move up
k - to move down
g - to move right

i - activate insert mode
I - activate insert mode (on start line)

a - activate insert mode
A - activate insert mode (on end line)

ctrl+c or esc - back no normal mode
	
w - to jump on words
e - to jump on end of the word
b - to jump back on words
gg - to jump on the start
GG - to jump on the end

number+gg - jump to the line

o - create new line after cursor
O - create new line before cursor

dd - delete this hole line
u - undo
dw - delete word

yy - copy
yw - copy word
p - paste 

$ - to go end of line
0 - to go start of line


modes: 
inster mode (i) = for writing
normal mode (ctrl+c) = for commands
visual mpde (v) = for selecting?
replacing mode (shift+r) = for replacing hole line















hello  is of the printing and typesetting industry. Lorem Ipsum has been the industry's standard dummy text ever since the 1500s, when an unknown printer took r galley of type and scrambleg it to make a type specimen book.  



Lorem Ipsum is simply dummy text of the printing and typesetting industry. Lorem Ipsum has been the industry's standard dummy text ever since the 1500s, when an unknown printer took r galley of type and scrambleg it to make a type specimen book.  


Lorem Ipsum is simply dummy text of the printing and typesetting industry. Lorem Ipsum has been the industry's standard dummy text ever since the 1500s, when an unknown printer took r galley of type and scrambleg it to make a type specimen book.  



Lorem Ipsum is simply dummy text of the printing and typesetting industry. Lorem Ipsum has been the industry's standard dummy text ever since the 1500s, when an unknown printer took r galley of type and scrambleg it to make a type specimen book.  




It has survived not only five centuries, but also the leap into electronic typesetting, remaining essentially unchanged. It was popularised in the 1960s with the release of Letraset sheets containing Lorem Ipsum passages, and more recently with desktop publishing software like Aldus PageMaker including versions of Lorem Ipsum.
